NO ./path_to_the_north_texture
SO ./path_to_the_south_texture
WE ./path_to_the_west_texture
EA ./path_to_the_east_texture

F 220,100,0
C 225,30,0

      11111111111111111111111111111111111111111
     100000000000000000000000S000000000000000001
    100000000000000000000000000000000000000000001
   10011111111111111111111111111111111111111000001
  1001                                      100001
 1001                                        10001
 1001     1111                1111            101
 1001    1    1              1    1           101
 1001    1    1              1    1          101  1
 1001     1111                1111          101   1
 1001                                      111   101
 1001                                     1      101
 1001                                            101
 1001      1                       1             101
 1001       1                     1             1001
  1001       111111111111111111111             1001
   1001       1000000000000000001             1001
    1001       11111111111111111             10001
     1001                                   10001
      1001111111111111111111111111111111111100001
       100000000000000000000000000000000000000001
        1000000000000000000000000000000000000011
         1111111111111111111111111111111111111